11111111111111111111111111111111111111111111111111111111111111111111111111111111111111111111111111111111111111
1P0000000000CE000000000000000000000000000000000000000000000000000000000000000000000000000000000000000000000001
10000000000111000000000000000000000000000000000000000000000000000000000000000000000000000000000000000000000001
11111010000000000000000000000000000000000000000000000000000000000000000000000000000000000000000000000011111111
1111111C00000C000000000000000000000000000000000000000000000000000000000000000000000000000000000000000000000001
1111111C00000C000000000000000000000000000000000000000000000000000000000000000000000000000000000000000000000001
1111111C00000C000000000000000000000000000000000000000000000000000000000000000000000000000000000000000000000001
1111111C00000C000000000000000000000000000000000000000000000000000000000000000000000000000000000000000000000001
1111111C00000C000000000000000000000000000000000000000000000000000000000000000000000000000000000000000000000001
1111111C00000C000000000000000000000000000000000000000000000000000000000000000000000000000000000000000000000001
1111111C00000C000000000000000000000000000000000000000000000000000000000000000000000000000000000000000000000001
1111111C00000C000000000000000000000000000000000000000000000000000000000000000000000000000000000000000000000001
1111111C00000C000000000000000000000000000000000000000000000000000000000000000000000000000000000000000000000001
1111111C00000C000000000000000000000000000000000000000000000000000000000000000000000000000000000000000000000001
1111111C00000C000000000000000000000000000000000000000000000000000000000000000000000000000000000000000000000001
1111111C00000C000000000000000000000000000000000000000000000000000000000000000000000000000000000000000000000001
1111111C00000C000000000000000000000000000000000000000000000000000000000000000000000000000000000000000000000001
1111111C00000C000000000000000000000000000000000000000000000000000000000000000000000000000000000000000000000001
1111111C00000C000000000000000000000000000000000000000000000000000000000000000000000000000000000000000000000001
1111111C00000C000000000000000000000000000000000000000000000000000000000000000000000000000000000000000000000001
1111111C00000C000000000000000000000000000000000000000000000000000000000000000000000000000000000000000000000001
1111111C00000C000000000000000000000000000000000000000000000000000000000000000000000000000000000000000000000001
1111111C00000C000000000000000000000000000000000000000000000000000000000000000000000000000000000000000000000001
1111111C00000C000000000000000000000000000000000000000000000000000000000000000000000000000000000000000000000001
1111111C00000C000000000000000000000000000000000000000000000000000000000000000000000000000000000000000000000001
1111111C00000C000000000000000000000000000000000000000000000000000000000000000000000000000000000000000000000001
1111111C00000C000000000000000000000000000000000000000000000000000000000000000000000000000000000000000000000001
1111111C00000C000000000000000000000000000000000000000000000000000000000000000000000000000000000000000000000001
1111111C00000C000000000000000000000000000000000000000000000000000000000000000000000000000000000000000000000001
11111111111111111111111111111111111111111111111111111111111111111111111111111111111111111111111111111111111111