111111111111
10000P001001
1000C0001001
100000000001
1E0000000001
111111111111