11111111111111
10000000100001
10000P00000001
11100000011111
1010C000000E01
11111111111111