11111111111111
10000000000001
10000P00000001
100000E0000001
1000C000000001
11111111111111