111111111111
10000P000001
1000C0000001
100000000001
1E0000000001
111111111111