111111111111
10000P001001
1000C0001001
10000000C001
1E0000C00001
111111111111